Pseudonym	FASTA Sequence	
lizard	MHGGGPPSGDSACPLRTIKRVQFGVLSPDELKRMSVTEGGIKYPETTEGGRPKLGGLMDPRQGVIERTGRCQTCAGNMTECPGHFGHIELAKPVFHVGFLVKTMKVLRCVCFFCSKLLVDSNNPKIKD	
dragonfly	MLDCNQPRYLLKFEQIYLSKPTHWERDGAPSPMMPNEARLRNLTYSAPLYVDITKTVIKEGEEQLQTQHQKTFIGKIPIMLRSTYCLLNGLTDRDLCELNECPLDPGGYFIINGSEKVLIAQEK	
nutcracker	NDPNDYVEQDDILIVKLRKGQELRLRAYAKKGFGKEHAKWNPTAGVAFEYDPDNALRHTVYPKPEEWPKSEYSELDEDESQAPYDPNGKPERFYYNVESCGSLRPETIVLSALSGLKKKLSDLQTQLSHEIQSDVLTIN	
shearwater	MAAGGSDPRAGDVEEDASQLIFPKEFETAETLLNSEVHMLLEHRKQQNESAEDEQELSEVFMKTLNYTARFSRFKNRETIASVRSLLLQKKLHKFELACLANLCPETAEESKALIPSLEGRFEDEELQQILDDIQTKRSFQY	
lark	MDDEEETYRLWKIRKTIMQLCHDRGYLVTQDELDQTLEEFKAQFGDKPSEGRPRRTDLTVLVAHNDDPTDQMFVFFPEEPKVGIKTIKVYCQRMQEENITRALIVVQQGMTPSAKQSLVDMAPKYILEQFLRLVQ	
oystercatcher	MFYHISLEHEILLHPRYFGPNLLNTVKQKLFTEVEGTCTGKYGFVIAVTTIDNIGAGVIQPGRGFVLYPVKYKAIVFRPFKGEVVDAVVTQVNKVGLFTEIGPMSCFISRHSIPSEMEFDPNSNPPCYKTMDEDIVIQQDD	
stork	MDLILDVNIQIYPVDLGDKFRLVIASTLYEDGTLDDGEYNPTDDRPSRADQFEYVMYGKVYRIEGDETSTEAATRLSAYVSYGGLLMRLQGDANNLHGFEVDSRVYLLMKKLAF	
frog	MEPDGTYEPGFVGIRFCQECNNMLYPKEDKENRILLYACRNCDYQQEADNSCIYVNKITHEVDELTQIIADVSQDPTLPRTEDHPCQKCGHKEAVFFQSHSARAEDAMRLYYVCTAPHCGHRWTE	
whetear	MNAPPAFESFLLFEGEKKITINKDTKVPNACLFTINKEDHTLGNIIKSQLLKDPQVLFAGYKVPHPLEHKIIIRVQTTPDYSPQEAFTNAITDLISELSLLEERFRVAIKDKQEGIE	
moth	MDTQKDVQPPKQQPMIYICGECHTENEIKSRDPIRCRECGYRIMYKKRTKRLVVFDAR	
egret	MIIPVRCFTCGKIVGNKWEAYLGLLQAEYTEGDALDALGLKRYCCRRMLLAHVDLIEKLLNYAPLEK	
sunbleak	LAGIMQHDATKLLPSVTELFPEFRPGKVLRFLRLFGPGKNVPSVWRSARRKRKKKHRELIQEEQIQEVECSVESEVSQKSLWNYDYAPPPPPEQCLSDDEITMMAPVESKFSQSTGDIDKVTDTKPRVAEWRYGPARLWY	
petrel	MQSRAVDGFHSEEQQLLLQVQQQHQPQQQQHHHHHHHQQAQPQQTVPQQAQTQQVLIPASQQATAPQVIVPDSKLIQHMNASNMSAAATAATLALPAGVTPVQQILTNSGQLLQVVRAANGAQYIFQPQQ	
wagtail	MAYQLYRNTTLGNSLQESLDELIQSQQITPQLALQVLLQFDKAINAALAQRVRNRVNFRGSLNTYRFCDNVWTFVLNDVEFREVTELIKVDKVKIVACDGKNTGSNTTE	
scorpionfly	MASTSRLDALPRVTCPNHPDAILVEDYRAGDMICPECGLVVGDRVIDVGSEWRTFSNDKATKDPSRVGDSQNPLLSDGDLSTMIGKGTGAASFDEFGNSKYQNRRTMSSSDRAMMNAFKEITTMADRINLPRNI	
hawk moth	SGQAPQLFHSQTLTTAPLPGTTPLYPSPMTPMTPITPATPASESSGIVPQLQNIVSTVNLGCKLDLKTIALRARNAEYNPKRFAAVIMRIREPRTTALIFSSGKMVCTGAKSEEQSRLAARKYARVVQKLGFPAKFLDFK	
ptarmigan	MDELFPLIFPAEPAQASGPYVEIIEQPKQRGMRFRYKCEGRSAGSIPGERSTDTTKTHPTIKINGYTGPGTVRISLVTKDPPHRPHPHELVGKDCRDGFYEAELCPDRCIHSFQNLGIQCVKKRDLEQAISQRIQTNNN	
anchovy	MAEDDPYLGRPEQMFHLDPSLTHTIFNPEVFQPQMALPTDGPYLQILEQPKQRGFRFRYVCEGPSHGGLPGASSEKNKKSYPQVKICNYVGPAKVIVQLVTNGKNIHLHAHSLVGKHCEDGICTVTAGPKDMV	
sandpiper	MPLLNLSLDLSLNPMNFIQPGAFKEIRLHKLTLRNNFDSLNVMKTCIQGLAGLEVHRLVLGEFRNEGNLEKFDKSALEGLCNLTIEEFRLAYLDYYLDDIIDLFNCLTNVSSFSLVSVTIERVKDFSYNFGWQHLELVNC	
thrush	MGTPKPRILPWLVSQLDLGQLEGVAWVNKSRTRFRIPWKHGLRQDAQQEDFGIFQAWAEATGAYVPGRDKPDLPTWKRNFRSALNRKEGLRLAEDRSKDPHDPHKIYEFVNSGVGDFSQPDTSPDTNGGGS	
jewel beetle	MMFSGFNADYEASSSRCSSASPAGDSLSYYHSPADSFSSMGSPVNAQDFCTDLAVSSANFIPTVTAISTSPDLQWLVQPALVSSVAPSQTRAPHPFGVPAPSAGAYSRAGVVKTMTGGRAQSIGRRGKVEQLS	
wigeon	MALLFLLPLVMQGVSRAEMGTADLGPSSVPTPTNVTIESYNMNPIVYWEYQIMPQVPVFTVEVKNYGVKNSEWIDACINISHHYCNISDHVGDPSNSLWVRVKARVGQKESAYAKSEEFAVCRDGKIGPPKL	
redshank	MRPTLLWSLLLLLGVFAAAAAAPPDPLSQLPAPQHPKIRLYNAEQVLSWEPVALSNSTRPVVYQVQFKYTDSKWFTADIMSIGVNCTQITATECDFTAASPSAGFPMDFNVTLRLRAELGALHSAWVTMPWFQ	
dorbeetle	MHGGGPPSGDSACPLRTIKRVQFGVLSPDELKRMSVTEGGIKYPETTEGGRPKLGGLMDPRQGVIERTGRCQTCAGNMTECPGHFGHIELAKPVFHVGFLVKTMKVLRCVCFFCSKLLVDSNNPKIKD	
mackerel	MLDCNQPRYLLKFEQIYLSKPTHWERDGAPSPMMPNEARLRNLTYSAPLYVDITKTVIKEGEEQLQTQHQKTFIGKIPIMLRSTYCLLNGLTDRDLCELNECPLDPGGYFIINGSEKVLIAQEK	
rockling	NDPNDYVEQDDILIVKLRKGQELRLRAYAKKGFGKEHAKWNPTAGVAFEYDPDNALRHTVYPKPEEWPKSEYSELDEDESQAPYDPNGKPERFYYNVESCGSLRPETIVLSALSGLKKKLSDLQTQLSHEIQSDVLTIN	
beetle	MAAGGSDPRAGDVEEDASQLIFPKEFETAETLLNSEVHMLLEHRKQQNESAEDEQELSEVFMKTLNYTARFSRFKNRETIASVRSLLLQKKLHKFELACLANLCPETAEESKALIPSLEGRFEDEELQQILDDIQTKRSFQY	
eel	MDDEEETYRLWKIRKTIMQLCHDRGYLVTQDELDQTLEEFKAQFGDKPSEGRPRRTDLTVLVAHNDDPTDQMFVFFPEEPKVGIKTIKVYCQRMQEENITRALIVVQQGMTPSAKQSLVDMAPKYILEQFLRLVQ	
robin	MFYHISLEHEILLHPRYFGPNLLNTVKQKLFTEVEGTCTGKYGFVIAVTTIDNIGAGVIQPGRGFVLYPVKYKAIVFRPFKGEVVDAVVTQVNKVGLFTEIGPMSCFISRHSIPSEMEFDPNSNPPCYKTMDEDIVIQQDD	
goldfinch	LAGIMQHDATKLLPSVTELFPEFRPGKVLRFLRLFGPGKNVPSVWRSARRKRKKKHRELIQEEQIQEVECSVESEVSQKSLWNYDYAPPPPPEQCLSDDEITMMAPVESKFSQSTGDIDKVTDTKPRVAEWRYGPARLWY	
eider	SGQAPQLFHSQTLTTAPLPGTTPLYPSPMTPMTPITPATPASESSGIVPQLQNIVSTVNLGCKLDLKTIALRARNAEYNPKRFAAVIMRIREPRTTALIFSSGKMVCTGAKSEEQSRLAARKYARVVQKLGFPAKFLDFK	