Pseudonym   FASTA Sequence	
loon	MHGGGPPSGDSACPLRTIKRVQFGVLSPDELKRMSVTEGGIKYPETTEGGRPKLGGLMDPRQGVIERTGRCQTCAGNMTECPGHFGHIELAKPVFHVGFLVKTMKVLRCVCFFCSKLLVDSNNPKIKD	
flying squirrel	MLDCNQPRYLLKFEQIYLSKPTHWERDGAPSPMMPNEARLRNLTYSAPLYVDITKTVIKEGEEQLQTQHQKTFIGKIPIMLRSTYCLLNGLTDRDLCELNECPLDPGGYFIINGSEKVLIAQEK	
vole	NDPNDYVEQDDILIVKLRKGQELRLRAYAKKGFGKEHAKWNPTAGVAFEYDPDNALRHTVYPKPEEWPKSEYSELDEDESQAPYDPNGKPERFYYNVESCGSLRPETIVLSALSGLKKKLSDLQTQLSHEIQSDVLTIN	
chipmunk	MAAGGSDPRAGDVEEDASQLIFPKEFETAETLLNSEVHMLLEHRKQQNESAEDEQELSEVFMKTLNYTARFSRFKNRETIASVRSLLLQKKLHKFELACLANLCPETAEESKALIPSLEGRFEDEELQQILDDIQTKRSFQY	
hermit beetle	MDDEEETYRLWKIRKTIMQLCHDRGYLVTQDELDQTLEEFKAQFGDKPSEGRPRRTDLTVLVAHNDDPTDQMFVFFPEEPKVGIKTIKVYCQRMQEENITRALIVVQQGMTPSAKQSLVDMAPKYILEQFLRLVQ	
hedgehog	MFYHISLEHEILLHPRYFGPNLLNTVKQKLFTEVEGTCTGKYGFVIAVTTIDNIGAGVIQPGRGFVLYPVKYKAIVFRPFKGEVVDAVVTQVNKVGLFTEIGPMSCFISRHSIPSEMEFDPNSNPPCYKTMDEDIVIQQDD	
wasp	MDLILDVNIQIYPVDLGDKFRLVIASTLYEDGTLDDGEYNPTDDRPSRADQFEYVMYGKVYRIEGDETSTEAATRLSAYVSYGGLLMRLQGDANNLHGFEVDSRVYLLMKKLAF	
shearwater	MEPDGTYEPGFVGIRFCQECNNMLYPKEDKENRILLYACRNCDYQQEADNSCIYVNKITHEVDELTQIIADVSQDPTLPRTEDHPCQKCGHKEAVFFQSHSARAEDAMRLYYVCTAPHCGHRWTE	
cuckoo	MNAPPAFESFLLFEGEKKITINKDTKVPNACLFTINKEDHTLGNIIKSQLLKDPQVLFAGYKVPHPLEHKIIIRVQTTPDYSPQEAFTNAITDLISELSLLEERFRVAIKDKQEGIE	
lizard	MDTQKDVQPPKQQPMIYICGECHTENEIKSRDPIRCRECGYRIMYKKRTKRLVVFDAR	
heron	MIIPVRCFTCGKIVGNKWEAYLGLLQAEYTEGDALDALGLKRYCCRRMLLAHVDLIEKLLNYAPLEK	
zope	LAGIMQHDATKLLPSVTELFPEFRPGKVLRFLRLFGPGKNVPSVWRSARRKRKKKHRELIQEEQIQEVECSVESEVSQKSLWNYDYAPPPPPEQCLSDDEITMMAPVESKFSQSTGDIDKVTDTKPRVAEWRYGPARLWY	
water vole	MQSRAVDGFHSEEQQLLLQVQQQHQPQQQQHHHHHHHQQAQPQQTVPQQAQTQQVLIPASQQATAPQVIVPDSKLIQHMNASNMSAAATAATLALPAGVTPVQQILTNSGQLLQVVRAANGAQYIFQPQQ	
rat	MAYQLYRNTTLGNSLQESLDELIQSQQITPQLALQVLLQFDKAINAALAQRVRNRVNFRGSLNTYRFCDNVWTFVLNDVEFREVTELIKVDKVKIVACDGKNTGSNTTE	
dormouse	MASTSRLDALPRVTCPNHPDAILVEDYRAGDMICPECGLVVGDRVIDVGSEWRTFSNDKATKDPSRVGDSQNPLLSDGDLSTMIGKGTGAASFDEFGNSKYQNRRTMSSSDRAMMNAFKEITTMADRINLPRNI	
fruitfly	SGQAPQLFHSQTLTTAPLPGTTPLYPSPMTPMTPITPATPASESSGIVPQLQNIVSTVNLGCKLDLKTIALRARNAEYNPKRFAAVIMRIREPRTTALIFSSGKMVCTGAKSEEQSRLAARKYARVVQKLGFPAKFLDFK	
dunlin	MDELFPLIFPAEPAQASGPYVEIIEQPKQRGMRFRYKCEGRSAGSIPGERSTDTTKTHPTIKINGYTGPGTVRISLVTKDPPHRPHPHELVGKDCRDGFYEAELCPDRCIHSFQNLGIQCVKKRDLEQAISQRIQTNNN	
grasshopper	MAEDDPYLGRPEQMFHLDPSLTHTIFNPEVFQPQMALPTDGPYLQILEQPKQRGFRFRYVCEGPSHGGLPGASSEKNKKSYPQVKICNYVGPAKVIVQLVTNGKNIHLHAHSLVGKHCEDGICTVTAGPKDMV	
caterpillar	MPLLNLSLDLSLNPMNFIQPGAFKEIRLHKLTLRNNFDSLNVMKTCIQGLAGLEVHRLVLGEFRNEGNLEKFDKSALEGLCNLTIEEFRLAYLDYYLDDIIDLFNCLTNVSSFSLVSVTIERVKDFSYNFGWQHLELVNC	
treecreeper	MGTPKPRILPWLVSQLDLGQLEGVAWVNKSRTRFRIPWKHGLRQDAQQEDFGIFQAWAEATGAYVPGRDKPDLPTWKRNFRSALNRKEGLRLAEDRSKDPHDPHKIYEFVNSGVGDFSQPDTSPDTNGGGS	
backswimmer	MMFSGFNADYEASSSRCSSASPAGDSLSYYHSPADSFSSMGSPVNAQDFCTDLAVSSANFIPTVTAISTSPDLQWLVQPALVSSVAPSQTRAPHPFGVPAPSAGAYSRAGVVKTMTGGRAQSIGRRGKVEQLS	
lapwing	MALLFLLPLVMQGVSRAEMGTADLGPSSVPTPTNVTIESYNMNPIVYWEYQIMPQVPVFTVEVKNYGVKNSEWIDACINISHHYCNISDHVGDPSNSLWVRVKARVGQKESAYAKSEEFAVCRDGKIGPPKL	
muskrat	MRPTLLWSLLLLLGVFAAAAAAPPDPLSQLPAPQHPKIRLYNAEQVLSWEPVALSNSTRPVVYQVQFKYTDSKWFTADIMSIGVNCTQITATECDFTAASPSAGFPMDFNVTLRLRAELGALHSAWVTMPWFQ	